ModuleName	Parameters	Inputs	Outputs	
CH_DW	DT_HS,CELLWIDTH,DEM,SLOPE,FLOW_DIR,CHWIDTH,FLOWOUT_INDEX_D8,FLOWIN_INDEX_D8,STREAM_LINK,REACHPARAMETER	D_QOVERLAND,D_QSOIL,D_P	QCH,QOUTLET,QSUBBASIN,HCH,CHWATH,CHQCH	
CH_MSK	DT_HS,CELLWIDTH,MSK_X,SLOPE,FLOW_DIR,CHWIDTH,FLOWOUT_INDEX_D8,FLOWIN_INDEX_D8,STREAM_LINK,REACHPARAMETER,CHS0	SBQG,D_QSOIL,D_QOVERLAND,D_P	QCH,QOUTLET,QSUBBASIN,HCH	
DEP_FS	DEPRE_IN,DEPRESSION	D_INLO,D_PET	DEET,DPST,SURU,STCAPSURPLUS	
GWATER_RESERVOIR	SUBBASIN,RCHPARAM,DT_HS,CELLWIDTH,KG,BASE_EX,GW0	D_PERCOLATION	SBQG,SBGS	
HS_WB	SUBBASIN,ROOTDEPTH,POROSITY,FIELDCAP,RCHPARAM,STREAM_LINK	D_QOVERLAND,D_QSOIL	SOWB,SBOF,SBIF	
IKW_CH	DT_HS,CELLWIDTH,FLOW_DIR,CHWIDTH,CH_MANNINGFACTOR,FLOWOUT_INDEX_D8,FLOWIN_INDEX_D8,STREAM_LINK,REACHPARAMETER	RADIANSLOPE,D_QOVERLAND,D_QSOIL,D_P,SBQG	QRECH,QOUTLET,QTOTAL,QSUBBASIN,HCH,CHWATH,CHQCH	
IKW_OL	DT_HS,CELLWIDTH,SLOPE,CHWIDTH,STREAM_LINK,MANNING,FLOW_DIR,FLOWOUT_INDEX_D8,FLOWIN_INDEX_D8,ROUTING_LAYERS	D_SURU,D_INFILCAPSURPLUS,D_INFIL,D_ACCUMUINFIL	QOVERLAND,REINFILTRATION,FLOWWIDTH,CHWIDTH,RADIANSLOPE,ID_OUTLET	
INTERFLOW_IKW	DT_HS,CELLWIDTH,SLOPE,CHWIDTH,STREAM_LINK,FLOWIN_INDEX_D8,ROUTING_LAYERS,CONDUCTIVITY,POROSITY,FIELDCAP,ROOTDEPTH,POREINDEX,KI	D_SOMO,D_SURU	QSOIL,RETURNFLOW	
ITP_P	WEIGHT,VERTICALINTERPOLATION,DEM,STATIONELEVATION,LAPSERATE	T_P	D_P	
ITP_TMIN	WEIGHT,VERTICALINTERPOLATION,DEM,STATIONELEVATION,LAPSERATE	T_TMIN	D_TMIN	
ITP_TMAX	WEIGHT,VERTICALINTERPOLATION,DEM,STATIONELEVATION,LAPSERATE	T_TMAX	D_TMAX	
ITP_PET	WEIGHT,VERTICALINTERPOLATION,DEM,STATIONELEVATION,LAPSERATE	T_PET	D_PET	
ITP_SR	WEIGHT,VERTICALINTERPOLATION,DEM,STATIONELEVATION,LAPSERATE	T_SR	D_SR	
ITP_WS	WEIGHT,VERTICALINTERPOLATION,DEM,STATIONELEVATION,LAPSERATE	T_WS	D_WS	
ITP_RM	WEIGHT,VERTICALINTERPOLATION,DEM,STATIONELEVATION,LAPSERATE	T_RM	D_RM	
PERCO_DARCY	DT_HS,CELLWIDTH,CONDUCTIVITY,POROSITY,POREINDEX,FIELDCAP,ROOTDEPTH	D_SOMO	PERCOLATION	
PI_STORM	SLOPE,DT_HS,INTERC_MAX,INTERC_MIN,PI_B,INIT_IS	D_P	INLO,NEPR	
SUR_SGA	DT_HS,CONDUCTIVITY,MOIST_IN,CLAY,SAND,POROSITY,ROOTDEPTH,FIELDCAP	D_NEPR,D_DPST,D_SURU	SOMO,INFIL,INFILCAPSURPLUS,ACCUMUINFIL	
TSD_RD_P	DATA_TYPE	T_P	T_P	
TSD_RD_TMIN	DATA_TYPE	T_TMIN	T_TMIN	
TSD_RD_TMAX	DATA_TYPE	T_TMAX	T_TMAX	
TSD_RD_PET	DATA_TYPE	T_PET	T_PET	
TSD_RD_SR	DATA_TYPE	T_SR	T_SR	
TSD_RD_WS	DATA_TYPE	T_WS	T_WS	
TSD_RD_RM	DATA_TYPE	T_RM	T_RM	
DEP_LINSLEY	DEPRE_IN,DEPRESSION	D_INET,D_PET,D_EXCP	DPST,DEET,SURU	
GWA_RE	TIMESTEP,CELLSIZE,CELLWIDTH,GW0,GWMAX,DF_COEF,KG,BASE_EX,ROOTDEPTH,SUBBASIN,SLOPE	D_PERCOLATION_2D,D_SOMO_2D,D_INET,D_DEET,D_SOET,D_PET,T_GWNEW	GWWB,REVAP,RG,SBQG,SBPET,SBGS	
IKW_REACH	DT_CH,K_CHB,K_BANK,EP_CH,BNK0,CHS0,VSEEP0,A_BNK,B_BNK,MSK_X,MSK_CO1,RCHPARAM,SUBBASIN	D_SBOF,D_SBIF,D_SBQG,D_SBPET,D_SBGS	QRECH,QOUTLET,QSOUTLET,QS,QI,QG,CHST,BKST,SEEPAGE,CHWTDEPTH	
IUH_IF	TIMESTEP,CELLWIDTH,OL_IUH,SUBBASIN	D_SSRU	SBIF	
IUH_OL	TIMESTEP,CELLWIDTH,SUBBASIN,OL_IUH	D_SURU	SBOF	
MUSK_CH	DT_CH,K_CHB,K_BANK,EP_CH,BNK0,CHS0,VSEEP0,A_BNK,B_BNK,MSK_X,MSK_CO1,VELSCALEFACTOR,RCHPARAM,SUBBASIN	D_SBOF,D_SBIF,D_SBQG,D_SBPET,D_SBGS	QRECH,QOUTLET,QSOUTLET,QS,QI,QG,CHST,BKST,SEEPAGE,CHWTDEPTH	
PER_PI	TIMESTEP,T_SOIL,ROOTDEPTH,CONDUCTIVITY_2D,POROSITY_2D,POREINDEX_2D,FIELDCAP_2D	D_SOTE,D_INFIL,D_SOMO_2D	PERCOLATION_2D	
PER_STR	TIMESTEP,T_SOIL,ROOTDEPTH,CONDUCTIVITY_2D,POROSITY_2D,POREINDEX_2D,FIELDCAP_2D	D_SOTE,D_INFIL,D_SOMO_2D	PERCOLATION_2D	
PET_H	K_PET,LATITUDE_M	TMAX,TMIN	T_PET	
PET_PM	CO2,COND_RATE,COND_MAX,T_SNOW,K_PET,STATIONELEVATION_M,LATITUDE_M	TMIN,TMAX,RM,SR,WS	T_PET	
PET_PT	T_SNOW,K_PET,STATIONELEVATION_M,LATITUDE_M	TMIN,TMAX,RM,SR	T_PET	
PI_MSM	INTERC_MAX,INTERC_MIN,PI_B,INIT_IS	D_P,D_PET	INLO,INET,NEPR	
SET_LM	ROOTDEPTH,T_SOIL,FIELDCAP_2D,WILTINGPOINT_2D	D_PET,D_INET,D_DEET,D_SOTE,D_SOMO_2D	SOET	
SNO_DD	C_SNOW,C_RAIN,T0,T_SNOW,SWE0	D_NEPR,D_TMIN,D_TMAX	SNME,SNAC	
SNO_SP	T0,K_BLOW,T_SNOW,SWE0,LAG_SNOW,C_SNOW6,C_SNOW12	D_NEPR,D_SNAC,SWE,D_SNRD,D_SNSB,D_TMIN,D_TMAX	SNME	
SNO_WB	CELLSIZE,K_BLOW,T0,T_SNOW,SWE0,SUBBASINSELECTED,SUBBASIN	D_NEPR,D_SNRD,D_SNSB,D_SNME,D_TMIN,D_TMAX,D_P,T_WS	SNAC,SNWB,SWE	
SOL_WB	SUBBASIN,ROOTDEPTH	D_P,D_NEPR,D_INLO,D_INET,D_DPST,D_DEET,D_INFIL,D_SOET,D_REVAP,D_SURU,T_RG,D_TMIN,D_TMAX,D_SOTE,D_PERCOLATION_2D,D_SOMO_2D,D_SSRU_2D	SOWB	
SSM_PE	K_SUBLI,K_BLOW,T0,T_SNOW,SWE0	D_PET,D_NEPR,D_SNAC,SWE,D_SNRD,D_TMIN,D_TMAX	SNSB	
SSR_DA	CELLWIDTH,TIMESTEP,KI,T_SOIL,CONDUCTIVITY_2D,POROSITY_2D,POREINDEX_2D,FIELDCAP_2D,ROOTDEPTH,SLOPE,CHWIDTH,STREAM_LINK,FLOWIN_INDEX_D8,ROUTING_LAYERS,SUBBASIN	D_GRRE,D_SOTE,D_SOMO_2D	SSRU_2D,SSRUVOL_2D,SBIF	
STP_FP	SOIL_TA0,SOIL_TA1,SOIL_TA2,SOIL_TA3,SOIL_TB1,SOIL_TB2,SOIL_TD1,SOIL_TD2,K_SOIL10,SOIL_T10	D_TMIN,D_TMAX	SOTE	
SUR_CN	T_SNOW,T_SOIL,T0,S_FROZEN,FIELDCAP_2D,POROSITY_2D,WILTINGPOINT_2D,ROOTDEPTH,CN2,MOIST_IN	D_NEPR,D_TMIN,D_TMAX,D_DPST,D_SOTE,D_SNAC,D_SNME	EXCP,INFIL,SOMO_2D	
SUR_MR	DT_HS,T_SNOW,T_SOIL,T0,K_RUN,P_MAX,ROOTDEPTH,RUNOFF_CO,MOIST_IN,FIELDCAP_2D,POROSITY_2D,S_FROZEN	D_NEPR,D_TMIN,D_TMAX,D_DPST,D_SOTE,D_SNAC,D_SNME	EXCP,INFIL,SOMO_2D	
KINWAVSED_CH	CELLWIDTH,DT_HS,CHTCCO,CHDETCO,SLOPE,USLE_K,CHWIDTH,FLOWOUT_INDEX_D8,FLOWIN_INDEX_D8,STREAM_LINK,REACHPARAMETER	HCH,QRECH,D_SEDTOCH	SEDSUBBASIN,SEDOUTLET,DEP,DET,QSN,CAP,CHANV,CHANVOL	
KINWAVSED_OL	CELLWIDTH,DT_HS,SLOPE,ECO1,ECO2,CCOE,USLE_K,USLE_C,STREAM_LINK,MANNING,CHWIDTH,FLOWIN_INDEX_D8,ROUTING_LAYERS	D_SURU,D_FLOWWIDTH,D_DETSPLASH,D_QOVERLAND	DETOVERLAND,SEDDEP,TESTV,TESTQV,SEDTOCH	
SPLASHERO_PARK	CELLWIDTH,DT_HS,OMEGA,USLE_K,USLE_C,SLOPE	D_DPST,D_SURU,D_QOVERLAND,D_NEPR	DETSPLASH	
SEDR_VCD	TIMESTEP,P_RF,SPCON,SPEXP,VCRIT,CHS0,RCHPARAM	SEDTOCH,SUBSEDTOCH,QRECH,QS,QI,QG,CHST,CHWTDEPTH	SEDRECH,T_CHSB,SEDOUTLET	
MUSLE_AS	CELLWIDTH,USLE_C,USLE_P,USLE_K,ACC,SLOPE,SUBBASIN,STREAM_LINK	D_SURU,D_SNAC	SOER,USLE_LS,SEDTOCH,SEDTOCH_T	
DISNUT_OL	DT_HS,CELLWIDTH,SLOPE,INITCONC_P,INITCONC_NH4,INITCONC_NO3,CLAY,POROSITY,CHWIDTH,STREAM_LINK,MANNING,FLOWIN_INDEX_D8,ROUTING_LAYERS	D_FLOWWIDTH,D_CELLQ,D_CELLH,D_INFIL,D_DPST,D_HTOCH	DISSOVP,AMMONIUM,NITRATEDISNUTOL,DISSOVPTOCH,AMMONIUMTOCH,NITRATETOCH,TESTDPST	
DISNUT_CH	DT_HS,CELLWIDTH,SLOPE,CHWIDTH,FLOWOUT_INDEX_D8,FLOWIN_INDEX_D8,STREAM_LINK,REACHPARAMETER	D_DISSOVPTOCH,D_AMMONIUMTOCH,D_NITRATETOCH,HCH,QCH	DISSOVP,AMMONIUM,NITRATE,DISSOVPOUTLET,AMMONIUMOUTLET,NITRATEOUTLET	
ATMDEP	ROOTDEPTH,CONRAINNITRA,CONRAINAMM	D_P	NITRATE,AMMON,DEPTH,ADDRAINNITRA,ADDRAINAMM	
DENITRI	DENRC	D_NITRATE,D_TF,D_WF	DENLOSTN	
MINDEC	RATECONST,HUMNF,RATECOEH,RATECOER,CONSOLUP,DENSITY_2D,FIELDCAP_2D	D_SOTE,D_NITRATE,D_SOMO_2D,D_DEPTH	CONHUMORGN,CONACTORGN,CONSTAORGN,HUMORGN,ACTORGN,STAORGN,FREORGN,TF,WF,TRAORGN,MINHUMN,CNRAT,CPRAT,RESCOMF,RATECONRD,MINFREORGN,DECFREORGN,SOLUP,HUMORGP,FREORGP,ACTORGP,STAORGP,MINHUMP,MINFREORGP,DECFREORGP	
NITVOL	CATEF,WILTINGPOINT_2D,FIELDCAP_2D	D_SOTE,D_SOMO_2D,D_DEPTH,D_NITRATE,D_AMMON	MIDZ,NITVOLTF,NITWF,VOLDF,NITR,VOLR,NITVOLAMMON,NITLOSTF,VOLLOSTF,CONNITRA,CONAMM	
NITFIX	FIELDCAP_2D	FR_PHU,SOMO_2D,D_NITRATE,D_DEMNIT	F_GS,F_SW,F_SN,FIXN	
NUTTRA_CH	TIMESTEP,P_RF,SPCON,SPEXP,VCRIT,CHS0,RCHPARAM	SNITTOCH,LANITTOCH,SAMMTOCH,SSOLPTOCH,ORGNTOCH,ATTPTOCH,QRECH,QS,QI,QG,CHST,CHWTDEPTH	NITOUTLET,AMMOUTLET,SOLUPOUTLET,ORGNOUTLET,ATTPOUTLET	
NUTTRA_OL	ANIEXCF,NITPC,POROSITY_2D,CLAY_2D,CELLWIDTH,DENSITY_2D,PARCOEP,SUBBASIN,CHWIDTH,STREAM_LINK,FLOWIN_INDEX_D8,ROUTING_LAYERS	D_NITRATE,D_SURU,D_SSRU_2D,D_PERCOLATION_2D,D_AMMON,D_SOER,D_DEPTH,D_ACTORGN,D_STAORGN,D_FREORGN,D_SOLUP,D_ACTMINP,D_STAMINP,D_HUMORGP,D_FREORGP	SURNIT,SATW,MOBQ,CONNIT,LATNIT,PERNIT,SURAMM,CONAMM,CONSED,ENRN,CONORGN,TRAORGN,SURSOLP,ENRP,CONATTP,TRAATTP,SNITTOCH,SNITTOCH_T,SAMMTOCH,SAMMTOCH_T,SSOLPTOCH,SSOLPTOCH_T,ORGNTOCH,ORGNTOCH_T,ATTPTOCH,ATTPTOCH_T,LANITTOCH,LANITTOCH_T	
SEDBONNUT_CH	STORM_DT,CELLWIDTH,SLOPE,CHWIDTH,FLOWOUT_INDEX_D8,FLOWIN_INDEX_D8,STREAM_LINK,REACHPARAMETER	D_SEDBONPTOCH,D_SEDBONAMMONIUMTOCH,HCH,QCH	SEDBONP,SEDBONAMMONIUM,SEDBONPOUTLET,SEDBONAMMONIUMOUTLET	
SEDBONNUT_OL	STORM_DT,CELLWIDTH,SLOPE,CLAY,POROSITY,DENSITY,CHWIDTH,STREAM_LINK,MANNING,FLOWIN_INDEX_D8,ROUTING_LAYERS	D_FLOWWIDTH,D_QOVERLAND,D_SURU,D_INFIL,D_DPST,D_HTOCH	SEDBONP,SEDBONAMMONIUM,SEDBONPTOCH,SEDBONAMMONIUMTOCH,TESTDPST	
SORPHO	SLOER	D_SOLUP	PAI,ACTMINP,STAMINP,TSOLACTP,TSTAACTP	
POTENTIALBIOMASS	IDC,EXT_COEF,BLAI,STARTDATE,ENDDATE,MAT_YRS,T_BASE,FRGRW1,FRGRW2,LAIMX1,LAIMX2,DLAI,BN1,BN2,BN3,BP1,BP2,BP3,CO2,BIO_E,BIOEHI,CO2HI,WAVP	D_TMIN,D_TMAX,D_SR,D_RM	BIOMASS_DELTA,BIOMASS,BIOMASS_NOPT,BIOMASS_POPT,VPD,FR_PHU,FR_N,FR_P,FR_ROOT,LAI_DELTA,LAI,LAI_PRE	
UPTAKEGROWTH	IDC,NFIXFACTOR,NFIXMAX,WDIS,WCOM,NDIS,PDIS,SOILLAYER,T_OPT,T_BASE,RDMX,FIELDCAP_2D,WILTINGPOINT_2D,BMX_TREES,MAT_YRS,BN1,BN2,BN3,BP1,BP2,BP3,DLAI,BLAI	D_TMIN,D_TMAX,D_PET,D_SOMO_2D,D_NITRATE,D_SOLUP,LAI_DELTA,LAI,LAI_PRE,FR_PHU,FR_N,FR_P,FR_ROOT,BIOMASS,BIOMASS_DELTA,BIOMASS_NOPT,BIOMASS_POPT	ROOTDEPTH,TRANSPIRATION_MAX,BIOMASS_N,BIOMASS_P,BIOMASS_ROOT,BIOMASS_AG,LAYER_WATERUPTAKE,LAYER_NUPTAKE,LAYER_PUPTAKE,N_FIXATION,TOTAL_WATERUPTAKE,TOTAL_NUPTAKE,TOTAL_PUPTAKE	
YIELD	IDC,CNYLD,CPYLD,HVSTI,WSYF,DLAI,HARVESTDATE	LAI,D_PET,D_SOET,FR_PHU,BIOMASS_N,BIOMASS_P,BIOMASS_AG,BIOMASS_ROOT,BIOMASS,TOTAL_WATERUPTAKE	YIELD_N,YIELD_P,YIELD	
